man - page [*]：查詢指令使用手冊。
date - page [*]：顯示日期及時間。
cal - page [*]：顯示日月曆。
bc - page [*]：簡單好用的計算機。
sync - page [*]：手動將緩衝於記憶體內的磁碟資料寫入磁碟。
who - page [*]：查看誰在線上。
netstat -a - page [*]：查看網路連線狀態。
shutdown - page [*]：通知線上使用者關機的時刻後關機。
halt - page [*]：關機。
reboot - page [*]：重新開機。
chgrp - page [*]：改變檔案所屬群組。
chown - page [*]：改變檔案擁有者。
chmod - page [*]：改變權限。
cd - page [*]：變換工作目錄。
pwd - page [*]：顯示目前所在的目錄。
mkdir - page [*]：建立新目錄。
rmdir - page [*]：刪除【空】的目錄。
echo - page [*]：顯示變數內容或文字。
ls - page [*]：顯示檔案名稱、屬性等。
cp - page [*]：拷貝檔案或目錄。
rm - page [*]：移除檔案或目錄。
mv - page [*]：檔案移動或改名。
basename - page [*]：移除前導目錄及字尾，顯示檔名。
dirname - page [*]：移除檔名，顯示目錄。
cat - page [*]：由第一行開始連續 (concatenate) 顯示檔案內容。
tac - page [*]：由最後一行開始連續顯示檔案內容。
more - page [*]：一頁一頁的顯示檔案內容。
less - page [*]：有 more 的功能且可以往前翻頁。
head - page [*]：只看頭幾行。
tail - page [*]：只看最後幾行。
nl - page [*]：顯示時亦輸出行號。
od - page [*]：以二進位的方式顯示檔案內容。
umask - page [*]：查詢及設定預設權限。
chattr - page [*]：改變檔案的隱藏屬性。
lsattr - page [*]：顯示檔案的隱藏屬性。
touch - page [*]：修改檔案時間，若檔案不存在，則產生新檔案。
which - page [*]：到環境變數 $PATH 指定的路徑，尋找可執行檔。
whereis - page [*]：在特定的目錄，尋找可執行檔、原始碼檔、manpage 檔案。
locate - page [*]：到檔案資料庫尋找檔案，資料庫可使用 updatedb 更新。
updatedb - page [*] 建立資料車 slocate.db 之設定。
find - page [*]：功能強大的檔案搜尋指令。
compress - page [*]：無法解開 *.gz 檔，已少人用了。
bzip2,bzcat - page [*]：以 bzcat 直接讀取 .bz2 壓縮檔案內容。
gzip,zcat - page [*]：以 zcat 直接讀取 .gz 壓縮檔案內容。
tar - page [*]：多用途打包壓縮指令。
dumpe2fs - page [*]：讀取 etx2/etx3 檔案系統的資訊。
df - page [*]：查看檔案系統空間的使用狀況。
du - page [*]：查看檔案或目錄容量。
ln - page [*]：檔案的連結。
fdisk - page [*]：對硬碟進行分割。
mke2fs - page [*]：磁碟格式化。
e2label - page [*]：更改磁碟的表頭資料。
fsck - page [*]：磁碟檢驗。
badblocks - page [*]：尋找磁碟壞的區塊。
mount - page [*]：掛載檔案系統。
dd - page [*]：把指定的輸入文件拷貝到指定的輸出文件中，並且在拷貝過程中可以進行格式轉換。
groups - page [*]：查詢目前帳號支援的群組。
newgrp - page [*]：變更有效群組。
useradd - page [*]：增加使用者。
passwd - page [*]：設定或變更密碼。
usermod - page [*]：用戶帳號相關資料微調。
userdel - page [*]：刪除使用者。
id - page [*]：查詢使用者的 UID、GID 及所擁有的群組。
groupadd - page [*]：增加群組。
groupmod - page [*]：group 相關參數的修改。
groupdel - page [*]：刪除群組。
gpasswd - page [*]：群組密碼管理。
su - page [*]：轉換用戶身份。
sudo - page [*]：不需要 root 的密碼，卻可執行 root 的工具。
visudo - page [*]：編輯 /etc/sudoers。
quotacheck - page [*]：quota 掃瞄
quotaon - page [*]：啟動 aquota.group 與 aquota.user。
edquota - page [*]：編輯每個『使用者』或『群組』的 quota 數值。
quota - page [*]：顯示目前群組或使用者的 quota 限值。
quotaoff - page [*]：關閉 quota 的限制。
at - page [*]：僅執行一次的工作排程。
crontab - page [*]：循環執行的工作排程。
jobs - page [*]：觀察目前的背景工作狀態。
bg - page [*]：讓工作在背景執行。
fg - page [*]：將背景工作拿到前景處理。
kill - page [*]：管理背景中的工作。
ps - page [*]：程序的觀察。
pstree - page [*]：顯示程序之間的相關性。
killall - page [*]：以指令名稱刪除程序。
free - page [*]：查閱記憶體。
uname - page [*]：顯示系統相關資訊。
uptime - page [*]：顯示目前系統已經開機多久時間。
dmesg - page [*]：列出開機訊息。
nice - page [*]：調整或給予程序的 nice 值。
renice - page [*]：改變正執行中的程序之 nice 值。
lilo - page [*]：啟動 LILO 開機管理程式。
grub - page [*]：安裝 grub 開機管理程式。